----------
/    --  t
-    --  -
*  -     -
-  /     -
-  -     p
-        -
-        -
------p---

SimpleTomato

2 1
7 1
7 7
2 7
