--------
--  -*--
-  tl  -
-      -
--  /  -
--  pp--
-  p  --
--  t  -
--l  /--
--------

Salad

2 7
3 3
4 3
5 4