--------
-l  -*--
-p --  -
-      -
-- l/  -
-t  ----
-t -  --
-- p-  -
--- p/--
--------

Salad

2 4
3 3
2 1
6 5