--------
- t  p -
-  t  p-
-/     -
- l    -
- *l   -
- /    -
-    p -
-      -
--------

Salad

1 5
4 4
3 1
2 3