--------
-l -- *-
-    - -
-l  -/--
-t p   -
-     --
- t    -
--   p--
-p-- /--
--------

Salad

2 8
2 2
5 5
6 6