--------
-      -
-      -
-/     -
-p     -
- *tl  -
- /    -
- t  p -
-   lp -
--------

Salad

5 2
3 2
1 5
2 3