--------
-  -- *-
-    p -
--  p/--
-t t   -
-     --
-      -
--   l--
-l-p /--
--------

Salad

3 2
3 7
2 3
2 5