--------
-      -
- p    -
-      -
-pl  / -
-      -
- p   /-
-t     -
- l t* -
--------

Salad

5 2
5 1
5 7
6 5